##############################################################
# 55554444     444422223333  33332222    5555       3333     #
# 4444 3333    333311114444  44443333    5555     33333333   #
# 3333  2222   4444          5555 4444   4444     33333333   #
# 2222   1111  5555 44441111 5555  5555  3333     33333333   #
# 1111    2222 444455553333  4444  4444  2222     33333333   #
# 2222   1111  5555 44441111 3333  3333  1111       3333     #
# 3333  2222   4444          3333   2222 3333                #
# 4444 3333    333311114444  4444    11114444       5555     #
# 55554444     444422223333  5555    55555555       5555     #
##############################################################