##############################################################
#555555555555555555555555555555555555555555555555555555555555#
#555544444444444444444444444444444444444444444444444444445555#
#555544443333333333333333333333333333333333333333333344445555#
#555544443333222222222222222222222222222222222222333344445555#
#555544443333222211111111111111111111111111112222333344445555#
#555544443333222222222222222222222222222222222222333344445555#
#555544443333333333333333333333333333333333333333333344445555#
#555544444444444444444444444444444444444444444444444444445555#
#555555555555555555555555555555555555555555555555555555555555#
##############################################################