##############################################################
#111122223333444455554444333311113333444455554444333322221111#
#222233334444555511113333444422224444333311115555444433332222#
#    3333444411112222555511111111111155552222111144443333    #
#        44445555333311112222111122221111333355554444        #
#            555544443333111122221111333344445555            #
#                2222444455551111555544442222                #
#                    33334444111144443333                    #
#                        111122221111                        #
#                            4444                            #
##############################################################