##############################################################
# 2222      3333         333333333333         3333       2222#
#  4444	  22224444      3333 2222 3333      44442222    4444 #
# 5555   2222  4444    3333111111113333    4444  2222    5555#
#  3333 2222    4444  33331111  11113333  4444    2222  3333 #
#   11112222     2222333311115555111133332222      22221111  #
#  3333 2222    2222  33331111  11113333  2222    2222  3333 #
# 5555   2222  2222    3333111111113333    2222  2222    5555#
#  4444   22222222      3333 2222 3333      22222222    4444 #
# 2222      5555         333333333333        5555        2222#
##############################################################