##############################################################
#111122223333444455551111333355552222444433331111555522221111#
#333344441111555544442222444422221111222211115555444433332222#
#    2222444411113333555511113333444455552222111133334444    #
#        55552222111144443333111122223333444455552222        #
#            333344445555111122221111222233334444            #
#                3333444455551111222233334444                #
#                    33334444555533334444                    #
#                        111122221111                        #
#                            5555                            #
##############################################################